40  30
3  2
85  85  85  85  85  85  85  85  85  85  85  85  85  85  85  85  85  85  85  85  85  85  85  85  85  85  85  85  85  85  85  85  85  85  85  85  85  85  85  85  
85  85  85  85  85  85  85  85  85  85  85  85  85  85  85  85  85  85  85  85  85  85  85  85  85  85  85  85  85  85  85  85  85  85  85  85  85  85  85  85  
85  499  0  0  86  0  0  33  0  0  31  0  0  37  85  85  0  0  0  85  86  0  0  0  85  85  85  0  0  85  85  85  85  85  85  85  85  85  85  85  
85  0  0  0  0  0  0  33  0  0  39  0  0  0  0  0  40  0  0  85  0  0  0  0  0  0  0  31  0  0  0  85  0  33  0  0  0  0  85  85  
85  0  0  33  0  0  39  0  0  0  33  0  0  86  0  0  0  0  86  85  85  0  0  0  31  0  0  0  0  0  0  0  0  0  0  0  0  86  85  85  
85  85  0  0  0  0  0  0  0  86  0  0  0  0  0  0  0  0  0  85  85  40  0  0  0  0  0  0  0  0  0  0  86  0  0  0  0  0  0  85  
85  54  0  0  0  0  33  0  0  0  0  0  0  0  33  0  0  0  0  85  0  0  0  0  33  0  0  0  54  0  0  0  0  0  0  0  0  0  0  85  
85  0  0  0  0  0  0  0  0  0  0  33  0  0  0  0  0  0  0  85  0  0  0  0  0  0  0  0  0  0  0  0  0  0  0  0  0  0  0  85 
85  85  85  0  0  0  0  0  0  0  0  0  0  0  0  0  0  0  54  85  34  0  0  0  0  0  0  0  34  0  0  0  0  0  0  85  85  0  0  85  
85  85  85  0  39  0  40  0  0  0  0  0  86  0  0  0  0  0  0  85  0  0  0  0  37  0  0  0  0  0  0  0  0  0  31  85  85  0  0  85  
85  0  0  0  0  0  0  0  0  0  0  0  0  0  0  0  0  0  0  85  0  0  0  0  0  0  0  0  0  0  0  0  0  0  0  0  0  0  0  85 
85  0  0  0  0  0  0  0  0  0  0  0  0  0  0  0  0  0  0  0  86  0  0  0  0  0  0  0  0  0  0  0  0  34  0  0  0  0  85  85  
85  85  85  85  85  85  85  85  0  0  0  0  31  0  0  0  0  0  0  0  31  0  0  0  0  0  0  0  0  0  0  0  0  34  0  0  0  0  0  85  
85  85  85  85  85  85  85  85  0  0  0  0  0  0  0  0  0  0  0  0  0  0  0  0  0  0  0  37  0  0  0  0  0  0  0  0  0  85  85  85  
85  85  0  0  37  0  0  0  0  0  0  0  0  33  0  0  0  0  0  0  0  0  0  0  31  0  0  0  0  0  0  85  85  85  0  33  0  85  85  85
85  0  0  0  0  0  0  0  0  0  0  0  0  0  0  0  0  0  85  85  31  0  0  0  85  85  85  85  85  85  85  85  85  85  85  85  85  85  85  85  
85  0  0  0  0  0  0  34  0  0  0  0  0  0  0  0  0  39  85  85  0  0  0  0  85  85  85  85  85  85  85  85  85  85  85  85  85  85  85  85  
85  0  0  54  0  0  0  0  0  0  0  0  0  0  0  0  0  0  0  85  0  0  0  86  0  0  0  0  0  0  86  0  85  85  85  85  85  85  85  85  
85  0  0  0  0  0  0  0  0  0  0  33  0  0  0  0  0  0  0  85  0  0  0  0  0  0  0  0  0  0  0  0  0  0  0  0  0  0  33  85  
85  0  0  0  0  0  0  0  0  0  0  0  0  0  0  0  0  0  0  85  0  0  0  0  0  0  0  0  31  0  0  0  0  0  0  85  85  85  85  85  
85  0  0  0  0  54  0  0  0  0  0  0  0  0  0  0  0  0  0  85  0  0  0  0  54  0  0  0  0  0  0  0  0  0  0  85  85  85  85  85 
85  85  0  0  0  0  0  0  0  85  85  85  0  0  0  0  0  0  0  85  0  0  0  0  0  0  0  0  0  0  0  0  0  0  0  0  0  0  0  85  
85  85  0  0  0  0  0  0  85  85  85  85  85  0  0  0  0  0  85  85  85  0  0  0  0  0  0  0  0  0  0  0  0  0  0  34  0  0  0  85  
85  85  0  0  40  0  0  0  85  85  85  85  85  0  0  0  0  0  85  85  85  0  0  0  86  0  0  34  0  0  0  0  0  0  0  0  0  0  0  85  
85  85  0  0  0  0  0  0  0  85  85  85  0  0  0  0  0  0  85  85  85  40  0  0  0  0  0  0  0  0  0  0  0  0  33  0  0  0  0  85  
85  0  0  0  0  0  0  0  0  0  0  0  0  0  0  0  0  0  85  85  85  0  0  0  0  0  0  0  0  0  0  0  0  0  0  0  0  0  0  85  
85  0  0  0  0  0  0  0  0  0  0  0  0  0  0  0  0  0  0  85  39  0  0  0  0  0  0  0  0  0  31  0  0  0  0  0  0  0  0  85 
85  85  0  0  0  0  0  0  0  0  31  0  0  0  0  0  0  0  85  85  85  85  0  0  0  0  0  0  0  0  0  0  0  0  0  0  0  0  85  85  
85  85  39  0  33  0  85  85  85  85  85  0  0  0  0  0  0  0  85  85  85  85  0  0  0  31  0  0  0  0  0  0  0  0  0  0  34  0  85  85  
85  85  85  85  85  85  85  85  85  85  85  85  85  85  85  85  85  85  85  85  85  85  85  85  85  85  85  85  85  85  85  85  85  85  85  85  85  85  85  85