40  30
2  1
85  85  85  85  85  85  85  85  85  85  85  85  85  85  85  85  85  85  85  85  85  85  85  85  85  85  85  85  85  85  85  85  85  85  85  85  85  85  85  85  
85  85  85  85  85  85  85  85  85  85  85  85  85  85  85  85  85  85  85  85  85  85  85  85  85  85  85  85  85  85  85  85  85  85  85  85  85  85  85  85  
85  0  0  0  0  0  0  0  0  0  0  0  0  0  85  85  0  0  0  85  0  0  0  0  85  85  85  0  0  85  85  85  85  85  85  85  85  85  85  85  
85  0  0  0  0  0  0  0  0  0  0  0  0  0  0  0  0  0  0  85  0  0  0  0  0  0  0  0  0  0  0  85  0  0  0  0  0  0  85  85  
85  0  0  0  0  0  0  0  0  0  0  0  0  0  0  0  0  0  0  85  85  0  0  0  0  0  0  0  0  0  0  0  0  0  0  0  0  0  85  85  
85  85  0  0  0  0  0  0  0  0  0  0  0  0  0  0  0  0  0  85  85  0  0  0  0  0  0  0  0  0  0  0  0  0  0  0  0  0  0  85  
85  0  0  0  0  0  0  0  0  0  0  0  0  0  0  0  0  0  0  85  0  0  0  0  0  0  0  0  0  0  0  0  0  0  0  0  0  0  0  85  
85  0  0  0  0  0  0  0  0  0  0  0  0  0  0  0  0  0  0  85  0  0  0  0  0  0  0  0  0  0  0  0  0  0  0  0  0  0  0  85 
85  85  85  0  0  0  0  0  0  0  0  0  0  0  0  0  0  0  0  85  0  0  0  0  0  0  0  0  0  0  0  0  0  0  0  85  85  0  0  85  
85  85  85  0  0  0  0  0  0  0  0  0  0  0  0  0  0  0  0  85  0  0  0  0  0  0  0  0  0  0  0  0  0  0  0  85  85  0  0  85  
85  0  0  0  0  0  0  0  0  0  0  0  0  0  0  0  0  0  0  85  0  0  0  0  0  0  0  0  0  0  0  0  0  0  0  0  0  0  0  85 
85  0  0  0  0  0  0  0  0  0  0  0  0  0  0  0  0  0  0  0  0  0  0  0  0  0  0  0  0  0  0  0  0  0  0  0  0  0  85  85  
85  85  85  85  85  85  85  85  0  0  0  0  0  0  0  0  0  0  0  0  0  0  0  0  0  0  0  0  0  0  0  0  0  0  0  0  0  0  0  85  
85  85  85  85  85  85  85  85  0  0  0  0  0  0  0  0  0  0  0  0  0  0  0  0  0  0  0  0  0  0  0  0  0  0  0  0  0  85  85  85  
85  85  0  0  0  0  0  0  0  0  0  0  0  0  0  0  0  0  0  0  0  0  0  0  0  0  0  0  0  0  0  85  85  85  0  0  0  85  85  85
85  0  0  0  0  0  0  0  0  0  0  0  0  0  0  0  0  0  85  85  0  0  0  0  85  85  85  85  85  85  85  85  85  85  85  85  85  85  85  85  
85  0  0  0  0  0  0  0  0  0  0  0  0  0  0  0  0  0  85  85  0  0  0  0  85  85  85  85  85  85  85  85  85  85  85  85  85  85  85  85  
85  0  0  0  0  0  0  0  0  0  0  0  0  0  0  0  0  0  0  85  0  0  0  0  0  0  0  0  0  0  0  0  85  85  85  85  85  85  85  85  
85  0  0  0  0  0  0  0  0  0  0  0  0  0  0  0  0  0  0  85  0  0  0  0  0  0  0  0  0  0  0  0  0  0  0  0  0  0  0  85  
85  0  0  0  0  0  0  0  0  0  0  0  0  0  0  0  0  0  0  85  0  0  0  0  0  0  0  0  0  0  0  0  0  0  0  85  85  85  85  85  
85  0  0  0  0  0  0  0  0  0  0  0  0  0  0  0  0  0  0  85  0  0  0  0  0  0  0  0  0  0  0  0  0  0  0  85  85  85  85  85 
85  85  0  0  0  0  0  0  0  85  85  85  0  0  0  0  0  0  0  85  0  0  0  0  0  0  0  0  0  0  0  0  0  0  0  0  0  0  0  85  
85  85  0  0  0  0  0  0  85  85  85  85  85  0  0  0  0  0  85  85  85  0  0  0  0  0  0  0  0  0  0  0  0  0  0  0  0  0  0  85  
85  85  0  0  0  0  0  0  85  85  85  85  85  0  0  0  0  0  85  85  85  0  0  0  0  0  0  0  0  0  0  0  0  0  0  0  0  0  0  85  
85  85  0  0  0  0  0  0  0  85  85  85  0  0  0  0  0  0  85  85  85  0  0  0  0  0  0  0  0  0  0  0  0  0  0  0  0  0  0  85  
85  0  0  0  0  0  0  0  0  0  0  0  0  0  0  0  0  0  85  85  85  0  0  0  0  0  0  0  0  0  0  0  0  0  0  0  0  0  0  85  
85  0  0  0  0  0  0  0  0  0  0  0  0  0  0  0  0  0  0  85  0  0  0  0  0  0  0  0  0  0  0  0  0  0  0  0  0  0  0  85 
85  85  0  0  0  0  0  0  0  0  0  0  0  0  0  0  0  0  85  85  85  85  0  0  0  0  0  0  0  0  0  0  0  0  0  0  0  0  85  85  
85  85  0  0  0  0  85  85  85  85  85  0  0  0  0  0  0  0  85  85  85  85  0  0  0  0  0  0  0  0  0  0  0  0  0  0  0  0  85  85  
85  85  85  85  85  85  85  85  85  85  85  85  85  85  85  85  85  85  85  85  85  85  85  85  85  85  85  85  85  85  85  85  85  85  85  85  85  85  85  85